E00000E00000E
0101010101010
0101010101010
0101012101010
0101000001010
0000010100000
2001100001102
0000010100000
0101011101010
0101010101010
0101011101010
0000P1G100000